1111111111111111111111111111111111
1E0E00000M00000C00000C0000M0000001
1010010100100000101001000000010101
1010010010101010001001000000010101
1P0000000C00C0000000000000M00000C1
1111111111111111111111111111111111
